season,name,age,team,games_played,games_started,wins,losses,ties,overtime_losses,saves,shots_against,save_percentage,goals_against_average,goals_against,shutouts
2023,Connor Hellebuyck,29,WPG,64,64,37,25,2,157,1964,1807,0.92,2.49,-157,4
2023,Juuse Saros,27,NSH,64,63,33,23,7,171,2099,1928,0.919,2.69,-171,2
2023,Alexandar Georgiev,26,COL,62,62,40,16,6,156,1904,1748,0.918,2.53,-156,5
2023,Jake Oettinger,24,DAL,62,61,37,11,11,144,1776,1632,0.919,2.37,-144,5
2023,Ilya Sorokin,27,NYI,62,60,31,22,7,140,1838,1698,0.924,2.34,-140,6
2023,Jordan Binnington,29,STL,61,60,27,27,6,194,1826,1632,0.894,3.31,-194,2
2023,Andrei Vasilevskiy,28,TBL,60,60,34,22,4,159,1875,1716,0.915,2.65,-159,4
2023,Jacob Markström,33,CGY,59,58,23,21,12,166,1542,1376,0.892,2.92,-166,1
2023,Igor Shesterkin,27,NYR,58,58,37,13,8,144,1719,1575,0.916,2.48,-144,3
2023,Darcy Kuemper,32,WSH,57,56,22,26,7,154,1674,1520,0.908,2.87,-154,5
2023,Ville Husso,27,DET,56,56,26,22,7,167,1603,1436,0.896,3.11,-167,4
2023,Carter Hart,24,PHI,55,54,22,23,10,155,1665,1510,0.907,2.94,-155,2
2023,John Gibson,29,ANA,53,52,14,31,8,200,1983,1783,0.899,3.99,-200,1
2023,Vítek Vaněček,27,NJD,52,48,33,11,4,119,1333,1214,0.911,2.45,-119,3
2023,Sergei Bobrovsky,34,FLA,50,49,24,20,3,145,1466,1321,0.901,3.07,-145,1
2023,Stuart Skinner,24,EDM,50,48,29,14,5,133,1536,1403,0.913,2.75,-133,1
2023,Karel Vejmelka,26,ARI,50,49,18,24,6,168,1670,1502,0.899,3.43,-168,3
2023,Linus Ullmark,29,BOS,49,48,40,6,1,91,1457,1366,0.938,1.89,-91,2
2023,Martin Jones,33,SEA,48,42,27,13,3,131,1145,1014,0.886,2.99,-131,3
2023,Tristan Jarry,27,PIT,47,47,24,13,7,128,1414,1286,0.909,2.9,-128,2
2023,Marc-André Fleury,38,MIN,46,45,24,16,4,126,1367,1241,0.908,2.85,-126,2
2023,James Reimer,34,SJS,43,41,12,21,8,147,1335,1188,0.89,3.48,-147,3
2023,Jake Allen,32,MTL,42,41,15,24,3,145,1335,1190,0.891,3.55,-145,1
2023,Ilya Samsonov,25,TOR,42,40,27,10,5,96,1184,1088,0.919,2.33,-96,4
2023,Jonathan Quick,37,2TM,41,36,16,15,6,127,1080,953,0.882,3.41,-127,2
2023,Jonathan Quick,37,LAK,31,27,11,13,4,99,798,699,0.876,3.5,-99,1
2023,Jonathan Quick,37,VEG,10,9,5,2,2,28,282,254,0.901,3.13,-28,1
2023,Sam Montembeault,26,MTL,40,39,16,19,3,133,1345,1212,0.901,3.42,-133,0
2023,Philipp Grubauer,31,SEA,39,36,17,14,4,98,930,832,0.895,2.85,-98,0
2023,Filip Gustavsson,24,MIN,39,37,22,9,7,81,1173,1092,0.931,2.1,-81,3
2023,Petr Mrázek,30,CHI,39,38,10,22,3,132,1248,1116,0.894,3.66,-132,0
2023,Joonas Korpisalo,28,2TM,39,37,18,14,4,104,1206,1102,0.914,2.87,-104,1
2023,Joonas Korpisalo,28,CBJ,28,26,11,11,3,82,926,844,0.911,3.17,-82,0
2023,Joonas Korpisalo,28,LAK,11,11,7,3,1,22,280,258,0.921,2.13,-22,1
2023,Casey DeSmith,31,PIT,38,33,15,16,4,109,1142,1033,0.905,3.17,-109,0
2023,Pheonix Copley,31,LAK,37,35,24,6,3,92,947,855,0.903,2.64,-92,1
2023,Kaapo Kähkönen,26,SJS,37,37,9,20,7,135,1149,1014,0.883,3.85,-135,1
2023,Jeremy Swayman,24,BOS,37,33,24,6,4,76,953,877,0.92,2.27,-76,4
2023,Logan Thompson,25,VEG,37,36,21,13,3,96,1132,1036,0.915,2.65,-96,2
2023,Jack Campbell,31,EDM,36,34,21,9,4,115,1027,912,0.888,3.41,-115,1
2023,Cam Talbot,35,OTT,36,32,17,14,2,95,935,840,0.898,2.93,-95,1
2023,Frederik Andersen,33,CAR,34,33,21,11,1,82,849,767,0.903,2.48,-82,1
2023,Ukko-Pekka Luukkonen,23,BUF,33,32,17,11,4,115,1054,939,0.891,3.61,-115,0
2023,Thatcher Demko,27,VAN,32,32,14,14,4,99,1005,906,0.901,3.16,-99,1
2023,Charlie Lindgren,29,WSH,31,26,13,11,3,86,853,767,0.899,3.05,-86,0
2023,Elvis Merzļikins,28,CBJ,30,27,7,18,2,110,889,779,0.876,4.23,-110,0
2023,Spencer Martin,27,VAN,29,27,11,15,1,107,830,723,0.871,3.99,-107,0
2023,Anton Forsberg,30,OTT,28,25,11,11,2,80,817,737,0.902,3.26,-80,2
2023,Adin Hill,26,VEG,27,25,16,7,1,61,721,660,0.915,2.45,-61,0
2023,Connor Ingram,25,ARI,27,26,6,13,8,89,960,871,0.907,3.37,-89,1
2023,Antti Raanta,33,CAR,27,26,19,3,3,58,644,586,0.91,2.23,-58,4
2023,Alex Stalock,35,CHI,27,24,9,15,2,74,804,730,0.908,3.01,-74,2
2023,Daniel Vladař,25,CGY,27,23,14,6,5,71,667,596,0.894,2.87,-71,0
2023,Craig Anderson,41,BUF,26,24,11,11,2,76,823,747,0.908,3.06,-76,1
2023,Matt Murray,28,TOR,26,26,14,8,2,74,761,687,0.903,3.01,-74,1
2023,Jaroslav Halák,37,NYR,25,24,10,9,5,66,680,614,0.903,2.72,-66,1
2023,Pyotr Kochetkov,23,CAR,24,23,12,7,5,57,627,570,0.909,2.44,-57,4
2023,Semyon Varlamov,34,NYI,23,22,11,9,2,60,689,629,0.913,2.7,-60,2
2023,Mackenzie Blackwood,26,NJD,22,20,10,6,2,60,563,503,0.893,3.2,-60,0
2023,Brian Elliott,37,TBL,22,22,12,8,2,75,689,614,0.891,3.4,-75,2
2023,Thomas Greiss,37,STL,21,16,7,10,0,65,626,561,0.896,3.58,-65,1
2023,Spencer Knight,21,FLA,21,19,9,8,3,62,627,565,0.901,3.18,-62,1
2023,David Rittich,30,WPG,21,18,9,8,1,50,506,456,0.901,2.67,-50,0
2023,Scott Wedgewood,30,DAL,21,18,9,8,3,51,603,552,0.915,2.72,-51,1
2023,Collin Delia,28,VAN,20,18,10,6,2,62,526,464,0.882,3.28,-62,0
2023,Felix Sandström,26,PHI,20,18,3,12,3,69,575,506,0.88,3.72,-69,0
2023,Eric Comrie,27,BUF,19,19,9,9,1,68,594,526,0.886,3.67,-68,1
2023,Lukáš Dostál,22,ANA,19,17,4,10,3,67,679,612,0.901,3.78,-67,0
2023,Kevin Lankinen,27,NSH,19,18,9,8,1,49,583,534,0.916,2.75,-49,0
2023,Anthony Stolarz,29,ANA,19,12,5,6,0,51,494,443,0.897,3.73,-51,0
2023,Mads Søgaard,22,OTT,19,17,8,6,3,58,524,466,0.889,3.32,-58,0
2023,Akira Schmid,22,NJD,18,14,9,5,2,32,408,376,0.922,2.13,-32,1
2023,Magnus Hellberg,31,2TM,18,14,5,8,1,50,447,397,0.888,3.2,-50,0
2023,Magnus Hellberg,31,OTT,1,1,1,0,0,2,31,29,0.935,2.0,-2,0
2023,Magnus Hellberg,31,DET,17,13,4,8,1,48,416,368,0.885,3.29,-48,0
2023,Daniil Tarasov,23,CBJ,17,16,4,11,1,57,528,471,0.892,3.91,-57,0
2023,Pavel Francouz,32,COL,16,16,8,7,1,42,493,451,0.915,2.61,-42,1
2023,Michael Hutchinson,32,CBJ,16,10,2,6,3,54,432,378,0.875,4.29,-54,0
2023,Alex Lyon,30,FLA,15,14,9,4,2,43,488,445,0.912,2.89,-43,1
2023,Alex Nedeljkovic,27,DET,15,13,5,7,2,49,466,417,0.895,3.53,-49,0
2023,Arvid Söderblom,23,CHI,15,13,2,10,2,48,453,405,0.894,3.45,-48,0
2023,Samuel Ersson,23,PHI,12,10,6,3,0,33,327,294,0.899,3.07,-33,1
2023,Laurent Brossoit,29,VEG,11,10,7,0,3,23,317,294,0.927,2.17,-23,0
2023,Erik Källgren,26,TOR,10,9,3,2,4,25,246,221,0.898,2.67,-25,0
2023,Calvin Petersen,28,LAK,10,9,5,3,2,34,257,223,0.868,3.75,-34,0
2023,Devon Levi,21,BUF,7,7,5,2,0,21,222,201,0.905,2.94,-21,0
2023,Ivan Prosvetov,23,ARI,7,7,4,3,0,28,234,206,0.88,3.98,-28,0
2023,Joseph Woll,24,TOR,7,7,6,1,0,15,219,204,0.932,2.16,-15,0
2023,Joel Hofer,22,STL,6,6,3,1,1,17,179,162,0.905,3.22,-17,0
2023,Jaxson Stauber,23,CHI,6,6,5,1,0,17,191,174,0.911,2.81,-17,0
2023,Joey Daccord,26,SEA,5,4,2,1,1,13,130,117,0.9,3.14,-13,0
2023,Arturs Silovs,21,VAN,5,5,3,2,0,14,152,138,0.908,2.75,-14,0
2023,Aaron Dell,33,SJS,4,3,0,3,0,9,103,94,0.913,2.71,-9,0
2023,Dustin Tokarski,33,PIT,4,2,1,2,0,12,117,105,0.897,3.44,-12,0
2023,Jon Gillies,29,CBJ,3,2,1,1,0,9,66,57,0.864,4.57,-9,0
2023,Jonas Johansson,27,COL,3,2,2,0,0,5,73,68,0.932,2.1,-5,0
2023,Kevin Mandolese,22,OTT,3,3,1,2,0,10,119,109,0.916,3.29,-10,0
2023,Matt Murray,24,DAL,3,3,1,2,0,10,64,54,0.844,3.39,-10,0
2023,Cayden Primeau,23,MTL,3,2,0,2,0,8,54,46,0.852,3.46,-8,0
2023,Justus Annunen,22,COL,2,2,1,1,0,7,48,41,0.854,3.58,-7,0
2023,Dylan Ferguson,24,OTT,2,2,1,1,0,5,83,78,0.94,2.52,-5,0
2023,Eetu Mäkiniemi,23,SJS,2,1,1,0,1,3,32,29,0.906,2.13,-3,0
2023,Leevi Merilainen,20,OTT,2,2,0,1,1,6,49,43,0.878,4.23,-6,0
2023,Jiří Patera,23,VEG,2,2,2,0,0,5,70,65,0.929,2.5,-5,0
2023,Keith Kinkaid,33,2TM,2,1,1,0,0,2,40,38,0.95,1.37,-2,0
2023,Keith Kinkaid,33,BOS,1,1,1,0,0,1,31,30,0.968,1.0,-1,0
2023,Keith Kinkaid,33,COL,1,0,0,0,0,1,9,8,0.889,2.15,-1,0
2023,Jett Alexander,23,TOR,1,0,0,0,0,0,0,0,0.0,0.0,0,0
2023,Yaroslav Askarov,20,NSH,1,1,0,1,0,4,35,31,0.886,4.15,-4,0
2023,Matthew Berlin,0,EDM,1,0,0,0,0,0,1,1,1.0,0.0,0,0
2023,Olle Eriksson Ek,23,ANA,1,1,0,0,1,5,39,34,0.872,4.69,-5,0
2023,Jet Greaves,21,CBJ,1,1,0,1,0,3,49,46,0.939,3.05,-3,0
2023,Anton Khudobin,36,CHI,1,1,0,1,0,6,28,22,0.786,6.0,-6,0
2023,Dylan Wells,25,CHI,1,0,0,0,0,1,13,12,0.923,3.0,-1,0
2023,Dustin Wolf,21,CGY,1,1,1,0,0,1,24,23,0.958,1.0,-1,0
2024,Juuse Saros,28,NSH,64,64,35,24,5,173,1845,1672,0.906,2.86,-173,3
2024,Alexandar Georgiev,27,COL,63,62,38,18,5,183,1770,1587,0.897,3.02,-183,2
2024,Connor Hellebuyck,30,WPG,60,60,37,19,4,142,1798,1656,0.921,2.39,-142,5
2024,Stuart Skinner,25,EDM,59,57,36,16,5,147,1553,1406,0.905,2.62,-147,2
2024,Sergei Bobrovsky,35,FLA,58,58,36,17,4,135,1584,1449,0.915,2.37,-135,6
2024,Jordan Binnington,30,STL,57,55,28,21,5,156,1786,1630,0.913,2.84,-156,3
2024,Petr Mrázek,31,CHI,56,53,18,31,4,160,1724,1564,0.907,3.05,-160,1
2024,Ilya Sorokin,28,NYI,56,55,25,19,12,167,1822,1655,0.908,3.01,-167,2
2024,Joonas Korpisalo,29,OTT,55,49,21,26,4,168,1523,1355,0.89,3.27,-168,0
2024,Igor Shesterkin,28,NYR,55,55,36,17,2,141,1606,1465,0.912,2.58,-141,4
2024,Ukko-Pekka Luukkonen,24,BUF,54,51,27,22,4,132,1470,1338,0.91,2.57,-132,5
2024,Jake Oettinger,25,DAL,54,53,35,14,4,140,1476,1336,0.905,2.72,-140,3
2024,Cam Talbot,36,LAK,54,52,27,20,6,130,1490,1360,0.913,2.5,-130,3
2024,Andrei Vasilevskiy,29,TBL,52,52,30,20,2,148,1477,1329,0.9,2.9,-148,2
2024,Thatcher Demko,28,VAN,51,51,35,14,2,123,1492,1369,0.918,2.45,-123,5
2024,Samuel Ersson,24,PHI,51,49,23,19,7,132,1204,1072,0.89,2.82,-132,4
2024,Tristan Jarry,28,PIT,51,48,19,25,5,133,1369,1236,0.903,2.91,-133,6
2024,Joey Daccord,27,SEA,50,46,19,18,11,116,1374,1258,0.916,2.46,-116,3
2024,Connor Ingram,26,ARI,50,48,23,21,3,136,1461,1325,0.907,2.91,-136,6
2024,Charlie Lindgren,30,WSH,50,48,25,16,7,127,1431,1304,0.911,2.67,-127,6
2024,Jacob Markström,34,CGY,48,48,23,23,2,131,1379,1248,0.905,2.78,-131,2
2024,John Gibson,30,ANA,46,44,13,27,2,151,1343,1192,0.888,3.54,-151,0
2024,Logan Thompson,26,VEG,46,42,25,14,5,119,1298,1179,0.908,2.7,-119,1
2024,Filip Gustavsson,25,MIN,45,43,20,18,4,129,1283,1154,0.899,3.06,-129,3
2024,Mackenzie Blackwood,27,SJS,44,41,10,25,4,140,1383,1243,0.899,3.45,-140,2
2024,Lukáš Dostál,23,ANA,44,38,14,23,3,129,1310,1181,0.902,3.33,-129,1
2024,Alex Lyon,31,DET,44,43,21,18,5,127,1325,1198,0.904,3.05,-127,2
2024,Jeremy Swayman,25,BOS,44,43,25,10,8,108,1287,1179,0.916,2.53,-108,3
2024,Pyotr Kochetkov,24,CAR,42,40,23,13,4,92,1031,939,0.911,2.33,-92,4
2024,Elvis Merzļikins,29,CBJ,41,40,13,17,8,130,1266,1136,0.897,3.45,-130,1
2024,Sam Montembeault,27,MTL,41,40,16,15,9,127,1307,1180,0.903,3.14,-127,0
2024,Marc-André Fleury,39,MIN,40,36,17,15,5,111,1056,945,0.895,2.98,-111,2
2024,Ilya Samsonov,26,TOR,40,40,23,7,8,120,1087,967,0.89,3.13,-120,3
2024,Linus Ullmark,30,BOS,40,39,22,10,7,103,1207,1104,0.915,2.57,-103,2
2024,Alex Nedeljkovic,28,PIT,38,33,18,7,7,102,1039,937,0.902,2.97,-102,1
2024,Karel Vejmelka,27,ARI,38,33,13,19,2,114,1089,975,0.895,3.35,-114,1
2024,Kaapo Kähkönen,27,2TM,37,33,7,24,3,116,1139,1023,0.898,3.64,-116,1
2024,Kaapo Kähkönen,27,SJS,31,27,6,20,3,105,996,891,0.895,3.81,-105,0
2024,Kaapo Kähkönen,27,NJD,6,6,1,4,0,11,143,132,0.923,2.51,-11,1
2024,Philipp Grubauer,32,SEA,36,34,14,16,2,95,941,846,0.899,2.85,-95,2
2024,Adin Hill,27,VEG,35,35,19,12,2,89,979,890,0.909,2.71,-89,2
2024,Jake Allen,33,2TM,34,33,12,18,4,114,1087,973,0.895,3.44,-114,0
2024,Jake Allen,33,MTL,21,21,6,12,3,74,686,612,0.892,3.65,-74,0
2024,Jake Allen,33,NJD,13,12,6,6,1,40,401,361,0.9,3.11,-40,0
2024,Darcy Kuemper,33,WSH,33,30,13,14,3,103,940,837,0.89,3.31,-103,1
2024,Arvid Söderblom,24,CHI,32,29,5,22,2,114,942,828,0.879,3.92,-114,0
2024,Vítek Vaněček,28,NJD,32,29,17,9,3,95,862,767,0.89,3.18,-95,0
2024,Scott Wedgewood,31,DAL,32,28,16,7,5,85,844,759,0.899,2.85,-85,0
2024,Anton Forsberg,31,OTT,30,28,15,12,0,84,765,681,0.89,3.21,-84,2
2024,Joel Hofer,23,STL,30,27,15,12,1,72,830,758,0.913,2.65,-72,1
2024,Casey DeSmith,32,VAN,29,27,12,9,6,80,759,679,0.895,2.89,-80,1
2024,Semyon Varlamov,35,NYI,28,27,14,8,4,69,837,768,0.918,2.6,-69,3
2024,Jonathan Quick,38,NYR,27,26,18,6,2,69,771,702,0.911,2.62,-69,2
2024,Anthony Stolarz,30,FLA,27,24,16,7,2,51,684,633,0.925,2.03,-51,2
2024,Carter Hart,25,PHI,26,25,12,9,3,68,727,659,0.906,2.8,-68,1
2024,Jonas Johansson,28,TBL,26,24,12,7,5,83,752,669,0.89,3.37,-83,2
2024,James Reimer,35,DET,25,20,11,8,2,70,727,657,0.904,3.11,-70,2
2024,Joseph Woll,25,TOR,25,23,12,11,1,72,772,700,0.907,2.94,-72,0
2024,Kevin Lankinen,28,NSH,24,17,11,6,0,56,610,554,0.908,2.82,-56,1
2024,Antti Raanta,34,CAR,24,20,12,7,2,63,493,430,0.872,2.99,-63,1
2024,David Rittich,31,LAK,24,22,13,6,3,49,621,572,0.921,2.15,-49,3
2024,Daniil Tarasov,24,CBJ,24,23,8,11,3,73,796,723,0.908,3.18,-73,0
2024,Laurent Brossoit,30,WPG,23,22,15,5,2,45,620,575,0.927,2.0,-45,3
2024,Devon Levi,22,BUF,23,21,10,8,2,67,666,599,0.899,3.1,-67,0
2024,Calvin Pickard,31,EDM,23,20,12,7,1,53,581,528,0.909,2.45,-53,1
2024,Cayden Primeau,24,MTL,23,21,8,9,4,66,731,665,0.91,2.99,-66,2
2024,Martin Jones,34,TOR,22,19,11,8,1,56,574,518,0.902,2.87,-56,2
2024,Nico Daws,23,NJD,21,20,9,11,0,60,568,508,0.894,3.15,-60,0
2024,Daniel Vladař,26,CGY,20,19,8,9,2,68,574,506,0.882,3.62,-68,0
2024,Ville Husso,28,DET,19,18,9,5,2,60,556,496,0.892,3.55,-60,0
2024,Akira Schmid,23,NJD,19,15,5,9,1,48,457,409,0.895,3.15,-48,0
2024,Spencer Martin,28,2TM,19,16,7,9,2,59,533,474,0.889,3.3,-59,0
2024,Spencer Martin,28,CBJ,13,10,3,8,1,43,379,336,0.887,3.65,-43,0
2024,Spencer Martin,28,CAR,6,6,4,1,1,16,154,138,0.896,2.63,-16,0
2024,Dustin Wolf,22,CGY,17,15,7,7,1,50,467,417,0.893,3.16,-50,0
2024,Frederik Andersen,34,CAR,16,16,13,2,0,28,410,382,0.932,1.84,-28,3
2024,Justus Annunen,23,COL,14,12,8,4,1,30,414,384,0.928,2.25,-30,2
2024,Ivan Prosvetov,24,COL,11,8,4,3,1,26,248,222,0.895,3.16,-26,0
2024,Eric Comrie,28,BUF,10,10,2,7,0,32,254,222,0.874,3.69,-32,0
2024,Magnus Chrona,23,SJS,9,8,1,6,1,37,262,225,0.859,4.71,-37,0
2024,Jet Greaves,22,CBJ,9,8,3,6,0,30,327,297,0.908,3.49,-30,0
2024,Pheonix Copley,32,LAK,8,8,4,1,2,23,177,154,0.87,3.16,-23,1
2024,Devin Cooley,26,SJS,6,6,2,3,1,25,192,167,0.87,4.98,-25,0
2024,Jiří Patera,24,VEG,6,5,1,3,1,21,196,175,0.893,3.98,-21,0
2024,Mads Søgaard,23,OTT,6,5,1,3,0,19,135,116,0.859,4.05,-19,0
2024,Matt Tomkins,29,TBL,6,6,3,2,1,20,185,165,0.892,3.33,-20,0
2024,Jack Campbell,32,EDM,5,5,1,4,0,20,157,137,0.873,4.5,-20,0
2024,Calvin Petersen,29,PHI,5,4,2,2,0,18,132,114,0.864,3.9,-18,0
2024,Felix Sandström,27,PHI,5,3,1,2,0,17,96,79,0.823,3.87,-17,0
2024,Hunter Shepard,28,WSH,4,4,2,1,1,13,123,110,0.894,3.19,-13,0
2024,Arturs Silovs,22,VAN,4,4,3,0,1,10,84,74,0.881,2.47,-10,0
2024,Ivan Fedotov,27,PHI,3,1,0,1,1,10,53,43,0.811,4.95,-10,0
2024,Magnus Hellberg,32,PIT,3,1,1,0,0,5,64,59,0.922,2.5,-5,0
2024,Jesper Wallstedt,21,MIN,3,3,2,1,0,9,87,78,0.897,3.01,-9,1
2024,Yaroslav Askarov,21,NSH,2,1,1,0,0,2,35,33,0.943,1.47,-2,0
2024,Chris Driedger,29,SEA,2,2,1,1,0,5,60,55,0.917,2.51,-5,0
2024,Georgi Romanov,24,SJS,2,0,0,0,0,1,30,29,0.967,1.01,-1,0
2024,Matt Villalta,24,ARI,2,1,0,1,0,5,29,24,0.828,4.17,-5,0
2024,Kenneth Appleby,28,NYI,1,0,0,0,0,2,8,6,0.75,6.0,-2,0
2024,Louis Domingue,31,NYR,1,1,1,0,0,1,26,25,0.962,1.0,-1,0
2024,Michael Hutchinson,33,DET,1,1,0,1,0,3,36,33,0.917,3.11,-3,0
2024,Matt Murray,25,DAL,1,1,1,0,0,0,23,23,1.0,0.0,0,1
2024,Yaniv Perets,23,CAR,1,0,0,0,0,0,1,1,1.0,0.0,0,0
2024,Malcolm Subban,30,CBJ,1,1,0,1,0,3,35,32,0.914,3.0,-3,0
2025,Connor Hellebuyck,31,WPG,63,62,47,12,3,125,1664,1539,0.925,2.0,-125,8
2025,Andrei Vasilevskiy,30,TBL,63,63,38,20,5,136,1716,1580,0.921,2.18,-136,6
2025,Sam Montembeault,28,MTL,62,60,31,24,7,166,1679,1513,0.901,2.82,-166,4
2025,Igor Shesterkin,29,NYR,61,61,27,29,5,167,1751,1584,0.905,2.86,-167,6
2025,Ilya Sorokin,29,NYI,61,60,30,24,6,158,1695,1537,0.907,2.71,-158,4
2025,Filip Gustavsson,26,MIN,58,58,31,19,6,146,1692,1546,0.914,2.56,-146,5
2025,Jake Oettinger,26,DAL,58,58,36,18,4,147,1611,1464,0.909,2.59,-147,2
2025,Juuse Saros,29,NSH,58,58,20,31,6,167,1592,1425,0.895,2.98,-167,4
2025,Jeremy Swayman,26,BOS,58,58,22,29,7,176,1632,1456,0.892,3.11,-176,4
2025,Karel Vejmelka,28,UTA,58,55,26,22,8,145,1507,1362,0.904,2.58,-145,1
2025,Joey Daccord,28,SEA,57,55,27,23,5,151,1599,1448,0.906,2.75,-151,2
2025,Jordan Binnington,31,STL,56,54,28,22,5,145,1457,1312,0.9,2.69,-145,3
2025,Mackenzie Blackwood,28,2TM,56,53,28,21,6,137,1549,1412,0.912,2.55,-137,4
2025,Mackenzie Blackwood,28,SJS,19,17,6,9,3,53,583,530,0.909,3.0,-53,1
2025,Mackenzie Blackwood,28,COL,37,36,22,12,3,84,966,882,0.913,2.33,-84,3
2025,Ukko-Pekka Luukkonen,25,BUF,55,55,24,24,5,169,1489,1320,0.887,3.2,-169,2
2025,Sergei Bobrovsky,36,FLA,54,54,33,19,2,130,1375,1245,0.905,2.44,-130,5
2025,Lukáš Dostál,24,ANA,54,49,23,23,7,158,1625,1467,0.903,3.1,-158,1
2025,Elvis Merzļikins,30,CBJ,53,52,26,21,5,168,1557,1389,0.892,3.18,-168,1
2025,Dustin Wolf,23,CGY,53,53,29,16,8,140,1549,1409,0.91,2.64,-140,3
2025,Kevin Lankinen,29,VAN,51,49,25,15,10,132,1345,1213,0.902,2.62,-132,4
2025,Stuart Skinner,26,EDM,51,50,26,18,4,138,1325,1187,0.896,2.81,-138,3
2025,Adin Hill,28,VEG,50,50,32,13,5,121,1293,1172,0.906,2.47,-121,4
2025,Darcy Kuemper,34,LAK,50,50,31,11,7,100,1266,1166,0.921,2.02,-100,5
2025,Jacob Markström,35,NJD,49,49,26,16,6,121,1213,1092,0.9,2.5,-121,4
2025,Alexandar Georgiev,28,2TM,49,47,15,26,4,165,1317,1152,0.875,3.71,-165,0
2025,Alexandar Georgiev,28,COL,18,17,8,7,0,53,421,368,0.874,3.38,-53,0
2025,Alexandar Georgiev,28,SJS,31,30,7,19,4,112,896,784,0.875,3.88,-112,0
2025,Samuel Ersson,25,PHI,47,45,22,17,5,136,1162,1026,0.883,3.14,-136,2
2025,Pyotr Kochetkov,25,CAR,47,47,27,16,3,121,1172,1051,0.897,2.6,-121,2
2025,Cam Talbot,37,DET,47,43,21,19,5,129,1295,1166,0.9,2.93,-129,2
2025,Linus Ullmark,31,OTT,44,43,25,14,3,112,1229,1117,0.909,2.72,-112,4
2025,Logan Thompson,27,WSH,43,42,31,6,6,105,1172,1067,0.91,2.49,-105,2
2025,Joseph Woll,26,TOR,42,41,27,14,1,111,1216,1105,0.909,2.73,-111,1
2025,Charlie Lindgren,31,WSH,39,38,20,14,3,104,985,881,0.894,2.73,-104,1
2025,Alex Nedeljkovic,29,PIT,38,35,14,15,5,112,1054,942,0.894,3.12,-112,1
2025,Petr Mrázek,32,2TM,38,38,12,21,2,116,1066,950,0.891,3.35,-116,1
2025,Petr Mrázek,32,CHI,33,33,10,19,2,106,964,858,0.89,3.46,-106,0
2025,Petr Mrázek,32,DET,5,5,2,2,0,10,102,92,0.902,2.49,-10,1
2025,Spencer Knight,23,2TM,38,36,17,16,3,100,1010,910,0.901,2.72,-100,2
2025,Spencer Knight,23,FLA,23,21,12,8,1,52,560,508,0.907,2.4,-52,2
2025,Spencer Knight,23,CHI,15,15,5,8,2,48,450,402,0.893,3.18,-48,0
2025,Tristan Jarry,29,PIT,36,35,16,12,6,105,970,865,0.892,3.12,-105,2
2025,Calvin Pickard,32,EDM,36,31,22,10,1,85,849,764,0.9,2.71,-85,0
2025,Arvid Söderblom,25,CHI,36,33,10,18,7,111,1087,976,0.898,3.18,-111,0
2025,David Rittich,32,LAK,34,31,16,14,2,88,771,683,0.886,2.84,-88,0
2025,Anthony Stolarz,31,TOR,34,33,21,8,3,71,955,884,0.926,2.14,-71,4
2025,Justus Annunen,24,2TM,34,29,15,15,1,95,814,719,0.883,3.18,-95,0
2025,Justus Annunen,24,COL,11,9,6,4,0,28,218,190,0.872,3.23,-28,0
2025,Justus Annunen,24,NSH,23,20,9,11,1,67,596,529,0.888,3.17,-67,0
2025,Jake Allen,34,NJD,31,29,13,16,1,77,819,742,0.906,2.66,-77,4
2025,Joel Hofer,24,STL,31,28,16,8,3,74,767,693,0.904,2.64,-74,1
2025,Anton Forsberg,32,OTT,30,27,11,12,3,76,768,692,0.901,2.72,-76,3
2025,Alex Lyon,32,DET,30,26,14,9,1,73,704,631,0.896,2.81,-73,1
2025,Daniel Vladař,27,CGY,30,29,12,11,6,83,810,727,0.898,2.8,-83,2
2025,John Gibson,31,ANA,29,28,11,11,2,72,811,739,0.911,2.77,-72,0
2025,Ilya Samsonov,27,VEG,29,29,16,9,4,82,752,670,0.891,2.82,-82,2
2025,Casey DeSmith,33,DAL,27,24,14,8,2,65,761,696,0.915,2.59,-65,2
2025,Joonas Korpisalo,30,BOS,27,24,11,10,3,74,693,619,0.893,2.9,-74,3
2025,Ivan Fedotov,28,PHI,26,24,6,13,4,75,624,549,0.88,3.15,-75,0
2025,Marc-André Fleury,40,MIN,26,22,14,9,1,68,670,602,0.899,2.93,-68,1
2025,Philipp Grubauer,33,SEA,26,26,8,17,1,85,681,596,0.875,3.49,-85,0
2025,Vítek Vaněček,29,2TM,25,24,5,14,4,84,724,640,0.884,3.62,-84,1
2025,Vítek Vaněček,29,SJS,18,17,3,10,3,63,533,470,0.882,3.88,-63,0
2025,Vítek Vaněček,29,FLA,7,7,2,4,1,21,191,170,0.89,3.0,-21,1
2025,Jonathan Quick,39,NYR,24,20,11,7,2,70,657,587,0.893,3.17,-70,3
2025,James Reimer,36,2TM,24,21,10,10,2,69,663,594,0.896,3.04,-69,1
2025,James Reimer,36,ANA,2,2,0,2,0,9,66,57,0.864,4.5,-9,0
2025,James Reimer,36,BUF,22,19,10,8,2,60,597,537,0.899,2.9,-60,1
2025,Scott Wedgewood,32,2TM,24,22,14,6,2,53,578,525,0.908,2.32,-53,2
2025,Scott Wedgewood,32,NSH,5,4,1,2,1,16,131,115,0.878,3.69,-16,0
2025,Scott Wedgewood,32,COL,19,18,13,4,1,37,447,410,0.917,1.99,-37,2
2025,Thatcher Demko,29,VAN,23,23,10,8,3,63,569,506,0.889,2.9,-63,1
2025,Frederik Andersen,35,CAR,22,22,13,8,1,55,546,491,0.899,2.5,-55,1
2025,Connor Ingram,27,UTA,22,22,9,8,4,66,558,492,0.882,3.27,-66,0
2025,Eric Comrie,29,WPG,20,20,9,10,1,47,547,500,0.914,2.39,-47,2
2025,Daniil Tarasov,25,CBJ,20,19,7,10,2,65,544,479,0.881,3.54,-65,1
2025,Jonas Johansson,29,TBL,19,18,9,6,3,58,554,496,0.895,3.13,-58,1
2025,Aleksei Kolosov,23,PHI,17,13,5,9,1,54,406,352,0.867,3.59,-54,0
2025,Jakub Dobes,23,MTL,16,15,7,4,3,40,440,400,0.909,2.74,-40,1
2025,Joel Blomqvist,23,PIT,15,12,4,9,1,49,425,376,0.885,3.81,-49,0
2025,Marcus Högberg,30,NYI,15,11,2,6,3,41,335,294,0.878,3.38,-41,0
2025,Yaroslav Askarov,22,SJS,13,12,4,6,2,37,357,320,0.896,3.1,-37,0
2025,Ville Husso,29,2TM,13,11,2,6,3,37,336,299,0.89,3.47,-37,0
2025,Ville Husso,29,DET,9,8,1,5,2,27,202,175,0.866,3.69,-27,0
2025,Ville Husso,29,ANA,4,3,1,1,1,10,134,124,0.925,2.99,-10,0
2025,Leevi Merilainen,22,OTT,12,11,8,3,1,22,295,273,0.925,1.99,-22,3
2025,Jet Greaves,23,CBJ,11,11,7,2,2,21,339,318,0.938,1.91,-21,2
2025,Cayden Primeau,25,MTL,11,7,2,3,1,41,250,209,0.836,4.7,-41,0
2025,Arturs Silovs,23,VAN,10,9,2,6,1,33,238,205,0.861,3.65,-33,0
2025,Semyon Varlamov,36,NYI,10,10,3,4,3,29,262,233,0.889,2.89,-29,0
2025,Devon Levi,23,BUF,9,8,2,7,0,33,258,225,0.872,4.12,-33,0
2025,Spencer Martin,29,CAR,9,7,3,4,1,27,175,148,0.846,3.89,-27,1
2025,Georgi Romanov,25,SJS,8,6,0,6,0,27,219,192,0.877,3.89,-27,0
2025,Nico Daws,24,NJD,6,4,3,1,0,7,114,107,0.939,1.6,-7,1
2025,Dennis Hildeby,23,TOR,6,6,3,3,0,20,156,136,0.872,3.33,-20,0
2025,Jaxson Stauber,25,UTA,6,4,2,1,1,17,158,141,0.892,3.26,-17,1
2025,Dustin Tokarski,35,CAR,6,6,4,2,0,13,132,119,0.902,2.18,-13,1
2025,Akira Schmid,24,VEG,5,3,2,0,1,5,90,85,0.944,1.26,-5,0
2025,Drew Commesso,22,CHI,2,1,0,1,0,4,26,22,0.846,3.36,-4,0
2025,Trent Miner,23,COL,2,1,0,1,0,4,33,29,0.879,2.62,-4,0
2025,Matt Murray,30,TOR,2,2,1,1,0,7,58,51,0.879,3.54,-7,0
2025,Olivier Rodrigue,24,EDM,2,1,0,1,0,4,29,25,0.862,3.1,-4,0
2025,Jakub Skarek,25,NYI,2,1,0,1,0,5,39,34,0.872,3.94,-5,0
2025,Mads Søgaard,24,OTT,2,1,1,1,0,8,40,32,0.8,5.24,-8,0
2025,Nikita Tolopilo,24,VAN,2,1,1,1,0,3,26,23,0.885,2.15,-3,0
2025,Jesper Wallstedt,22,MIN,2,2,0,2,0,8,51,43,0.843,4.09,-8,0
2025,Pheonix Copley,33,LAK,1,0,0,0,0,2,12,10,0.833,4.37,-2,0
2025,Sebastian Cossa,22,DET,1,0,1,0,0,2,14,12,0.857,2.67,-2,0
2025,Louis Domingue,32,NYR,1,1,1,0,0,2,27,25,0.926,2.0,-2,0
2025,Brandon Halverson,28,TBL,1,1,0,1,0,5,24,19,0.792,5.18,-5,0
2025,Kaapo Kähkönen,28,COL,1,1,0,1,0,4,20,16,0.8,4.12,-4,0
2025,Niklas Kokko,20,SEA,1,0,0,0,0,2,6,4,0.667,4.01,-2,0
2025,Tristan Lennox,22,NYI,1,0,0,0,0,1,2,1,0.5,12.72,-1,0
2025,Victor Ostman,24,SEA,1,0,0,0,0,0,12,12,1.0,0.0,0,0
2025,Yaniv Perets,24,CAR,1,0,0,0,0,1,7,6,0.857,7.32,-1,0
2025,Erik Portillo,24,LAK,1,1,1,0,0,1,29,28,0.966,1.02,-1,0
2025,Hunter Shepard,29,WSH,1,1,0,1,0,7,26,19,0.731,7.0,-7,0
2025,Clay Stevenson,25,WSH,1,1,0,1,0,5,38,33,0.868,5.0,-5,0
2025,Ales Stezka,28,SEA,1,1,0,1,0,3,23,20,0.87,3.09,-3,0
2025,Matt Villalta,25,UTA,1,1,1,0,0,3,31,28,0.903,3.0,-3,0
